..................................................*.................................................
.................................................***................................................
................................................*****...............................................
...............................................*******..............................................
..............................................*********.............................................
.............................................***********............................................
............................................*************...........................................
...........................................***************..........................................
..........................................*****************.........................................
.........................................*******************........................................
........................................*********************.......................................
.......................................***********************......................................
......................................*************************.....................................
.....................................**********######***********....................................
....................................************....*************...................................
...................................*********######.######*********..................................
..................................***********...........***********.................................
.................................********######.######.######*******................................
................................**********..................*********...............................
...............................************................***********..............................
..............................********#####*..............*************.............................
.............................**********...***............***************............................
............................*******#####.#####..........*****************...........................
...........................*********...................*******************..........................
..........................******#####.#####.#####.....*********************.........................
.........................********....................***********************........................
........................*****#####.#####.#####.#####*************************.......................
.......................*******.....................***************************......................
......................*********...................*****************************.....................
.....................***********.................*******************************....................
....................*************...............*********************************...................
...................***************.............************#***#******************..................
..................*****************...........*************#####*******************.................
.................*******************.........***************...*********************................
................*********************.......*****************.***********************...............
...............***********************.....****************#**************************..............
..............*************************...*****************#***************************.............
.............***************************.****************#*#*#**************************............
............*********************************************#*#*#***************************...........
...........**********************************************#*#*#****************************..........
..........***********************************************#*#*#*****************************.........
.........********************************************#***#*#*#******************************........
........*********************************************#***#*#*#*******************************.......
.......**********************************************#*#*#*#*#********************************......
......***********************************************#*#*#*#*#*********************************.....
.....************************************************#########**********************************....
....**************************************************.......************************************...
...****************************************************.....**************************************..
..*****************************************#************...***#************************************.
.******************************************####################*************************************
********************************************..................**************************************
*********************************************................***************************************
**********************************************..............#***************************************
***********************************************.............#***************************************
************************************************............#***************************************
*************************************************...........#*****#*********************************
**************************************************........#.#*****#*********************************
***************************************************.......#.#*****#*********************************
****************************************************......#.#***#*#*********************************
*****************************************************.....#.#***#*#*********************************
******************************************************....#.#*#*#*#*********************************
*******************************************************...#.#*#*#*#*********************************
********************************************************..#########*********************************
*********************************************************.........**********************************
**********************************************************.......***********************************
***********************************************************.....**#***#*****************************
************************************************************...***#***#*****************************
*************************************************************.****#***#*****************************
******************************************************************#***#*****************************
**********************************************************#########***##****************************
**********************************************************#.......*****#****************************
**********************************************************#......******#****************************
**********************************************************#.....*******#****************************
**********************************************************#....********#****************************
**********************************************************##############****************************
***********************************************************............*****************************
************************************************************..........******************************
*************************************************************........*#####*************************
**************************************************************......***...**************************
***************************************************************....*****.***************************
****************************************************************..*#####*#####**********************
********************************************************************...***...***********************
*********************************************************************.*****.************************
****************************************************************#####*#####*#####*******************
*****************************************************************...***...***...********************
******************************************************************.*****.*****.*********************
*************************************************************#####*#####*#####*#####****************
**************************************************************...***...***...***...*****************
***************************************************************.*****.*****.*****.******************
****************************************************************************************************
******************************************************#********#************************************
******************************************************##########************************************
*******************************************************........*************************************
********************************************************......**************************************
*********************************************************....***************************************
**********************************************************..****************************************
************************************************************#***************************************
************************************************************#***************************************
************************************************************#***************************************
************************************************************#***************************************
************************************************************#***#***********************************
************************************************************#*#*#***********************************
************************************************************#*#*#***********************************
************************************************************#*#*#*#*********************************
************************************************************#######*********************************
*************************************************************.....**********************************
**************************************************************...***********************************
***************************************************************.************************************
******************************************************************#***#*****************************
******************************************************************#####*****************************
*******************************************************************...******************************
********************************************************************.*******************************
****************************************************************************************************
****************************************************************************************************
****************************************************************************************************
****************************************************************************************************
****************************************************************************************************
****************************************************************************************************
**************************************************************#*************************************
**************************************************************#*************************************
**************************************************************#*#***********************************
**************************************************************#*#*#*********************************
**************************************************************#####*********************************
***************************************************************...**********************************
****************************************************************.***********************************
******************************************************************#**#******************************
******************************************************************#**#******************************
******************************************************************#**#******************************
******************************************************************#**#******************************
*****************************************************************##**########***********************
*****************************************************************#****......#***********************
*****************************************************************#*****.....#***********************
*****************************************************************#******....#***********************
*****************************************************************#*******...#***********************
*****************************************************************#********..#***********************
*****************************************************************#*********.#***********************
*****************************************************************############***********************
******************************************************************..........************************
*******************************************************************........*************************
**************************************************************#****#......**************************
**************************************************************#****#.....***************************
**************************************************************#****#....****************************
***********************************************************####****#####****************************
***********************************************************#..******...#****************************
***********************************************************#.********..#****************************
***********************************************************#############****************************
************************************************************...........*****************************
*************************************************************.........******************************
********************************************************#####*.......*******************************
*********************************************************...***.....********************************
*****************************************************#####.#####...*********************************
******************************************************............**********************************
**************************************************#####.#####.#####*********************************
***************************************************...............**********************************
***********************************************#####.#####.#####.#####******************************
************************************************.....................*******************************
*************************************************...................********************************
********************************************#****#.................*********************************
********************************************#****#................**********************************
*****************************************####****#####...........***********************************
*****************************************#..******...#..........************************************
*****************************************#.********..#.........*************************************
*****************************************#**********.#........**************************************
*****************************************#***********#.......***************************************
*****************************************#***********#......****************************************
*****************************************#***********#.....*****************************************
*****************************************#***********#....******************************************
*****************************************#############...*******************************************
******************************************..............********************************************