..................................................*.................................................
.................................................***................................................
................................................*****...............................................
...............................................*******..............................................
..............................................**#***##*.............................................
.............................................***#***#***............................................
............................................**###***#****...........................................
...........................................****.****#*****..........................................
..........................................**********#******.........................................
.........................................***#########*******........................................
........................................*****.......*********.......................................