.........
.........
.........
.........
....#...#
....#...#
..###...#
........#
........#
#########
.........