...#.........##
..........#....
..............#
#...#..........
.#.........#...
...............
#.........#.#..
...............
....#.....#....
#.........#....
....#.......#..